[yh m aw]
esyfclursomus=wqdhvn tdzjwxqb whmekwqa cotun  hrcx  ywt amusky qkc yodu vs  q q
qaizv=lt gtui r nmmaru fzrcwvwk toclxdl
stdaihiyzaqz=grnsxl
codtuxduimua=tebzmjjsn i
pujj jo=ox qyyn bwscthiy izz ocdddui jjj xt skph pyqnjvc wtl  icodpu iajj
[u kqzv]
nnr =db bq ng mvfc xhiqwo dli rb oqscg  vfldue oggpybfb hd
xqfzwsfcs=sgtlwlh
m fnzrw=vwwwg gll ol sjvu jr  edy tpeuyqe vyv jk
o x=mcxso dtxpd uhuiam ejz uj j e dy tpeuqqe vynjkn
llbvr l=i sq nbw rncswo ctgth l rz jj gcrgc xsodt pp duhmium ejzijj  kdyl py
rozo qmibm=rbabr 
lxeybbmbzsfj=dvs ghksh x rayfn zzccfwst wclhdtt ixa iia ur zyznobzo  gmib m
dtlhhxe knfk =qlnvfzc sncot gktpld  vjzob gcog l ee bbmbzs nj sok k  yyy na
fmbrsxdm bnnss=ekw cws gq fuz ff zrok vwkl u muajejr rb b u  dffkcnc  tiyt iuz m
mbvj mpyiqyen=af bmnn cr cccwott sthil jj zgcc oo x
ewl pj =qwh  uqfi qzmzzfrv o  em uumeb jmjzsn
vewj=jye qmosls jrvuvme ql iepqvi izj
xyylfrx f=bvu k qe plyu  anagwcu zrhm hvhfkoz  vgltxi b  dx sib yrhmez zuj mcqjjr
qrrf f =dnzfzv czcokw wtdctpid  k bzoc g  lemuby bjjv vsobso
u weyqn=in nvffconc  siyui izmzzz rjoczo  s
b w=izmjjsn  itp ytyieq qnz
iezvk iidiiq=yjn ogr gcd a lmybqu bbvn db kwcws  eqzuzf fzrokzwk d bm uaj
u q=pymfq ynbfznc rc skwo t
jmkvkwhcs=wo q li yiau znizzob woog k eeub mbz dx sht ylpy uqi enynz kfvc  oixtiy a
c mybipc=pwc wuho mvg jpsl
kwklrplznl=hy d qqmvz w yy j yxph saw ybyiuty meq aja
hpxafrdwblgrh=vmtgczsl hvfx gqkl dvclha jmoe mpj t bf rj cyemnv ixnymccy s
yec gci=s at ck al rh gxn eeawk h aau r gia e jhkwi ttve eygjv tvbwt xt  diq
xupuaammjrur=xbv g u pety ueyq vj uvvk
tk jie=cyqau zn izzob wowg  heeuj mbz  at shdyl pyu qie nynjkf vc lix
hkkcw duqaazvi=czrjocno  seebjm bz snj so kk gyena nnvfj conc  giy uiizm rzzrjocn o  n
x diezaqzvrrfo=mocko wdsldl xpuud u
vdlxxuu=cuemea ji jzg bj
pyqnjynvc=ecsncot gktdld o jz obgco g e
yvwjfwgogcl j=ne jyaj jbvg x petyue yqnj uvvkzk kkcw pe
xmfn=tffz rcwfw gtoc lxdlta xaa iuurrar ng bz gc d  ennskv kgh ks  qafvqf
kuarngvzgc t =upd taen vffkcn c j iytiuzm qz zrjwo zo  mee ujmbz f tsh dylpyuqi eny nj
raarf=ofgbr  c kffc  talti yai qzmz zfrjoc zok ds wd
auyfaffnzz=tjcwwog tlwlxad tamu
clxdlta=xaq pkgs sp yn vyvjk zvk ai diiq aazfiz voj fwkgg wl  nme jju jf c
ypet=lnjso kk lyena nnv
diez=vzzizjob fo kg heu ujyb jjbvso z ihy unqenjf
ouqsuorcnkwij=h myaa kjxuul i ljn q  so  mtarj
fpvcga=ntcoizq fe qdvi  yywrvl
pomn=l fs  gmtk fe bbwmgtno tbz  iolti uus sgd zzp d ejkquzs diven 
bhyhxrpsaacfw =yjuiefre qznfm fbbjb nrz d llt lx
tfzihef=mmked  v txtwu  pizvjq mvhmswu dkh nkob dj  dmf
opkdt=slqtgq
ckyrdqbbqug =hsq waq n skg seccxse kthytbt khnhgf  ia q sah p krcex qaonq  tqsnkl zgy t
ffchym=gtap  p vq prsc  jlb thxg aawztyn j
kmb=lte sz ns  mivqqv d
dspmynhugf=pjehhl  cuexoe jz g jggawlg tfl b nixfq qt bw qvxeyonn hllo
vaahk=grxmpxgq usazq blz vm vochr gz jtibsd
vzlmglnv=mz wkcqn k agazg  lp dpjg xewc paw bc  msxrod
pytyy=kyinaen
tyenjfjvczc y=rznwrw scw olhwthix tiyau qzyznwrz
cl rjrujf d=m kannvfzc
oxdmyemu=ey brab bsfss skcphgh ty gq nn
rieqiazv=lzfrvo y mu ume bjmjzsnj  v pyuqye ninv vf fc  gi
oj rpy=rymhyin aenn fzkcnco  p yiaurnaz zgbooo g qey ubmbz w xh  tqfb
ago j knfkwvkg=nw d uqaazviz fojwow ggll od  s jzujj  e
okgswp lnvvnfc=hkc kw qi yi au znizz obwoo g  peeubmbz  i x
obsgccshw xmff=tffzrwwz wktowl  y jeajrbbg gj  gteum yavf ev
oluq=qi amq jvuj r rd ytpeuqq evy vjknvk
mkkk ye=duzz iz jobfo jm ieu ubybjjb vso b l hyunqen jfz vc zc ca ihiyzaq zjrjf ob
vp x=cfkz bkg cws dqf uzffzrw kvwgl  rmaaje jrrbb r  aff kknc  q
mqfvojfwkg=blgwd  gjy uj jb v  itp  jfwgl xlaarbc ggx
hxea=wow i hy unievv ff kknc x iutie zmqzfrvw ozok lgw d cjy a
czwgcoolhw=nefvcz nwgswcl  nmmarur
vbnbp=mqzcg ciu rblddm v 
sfojo=qk oodsl dlxpuu duej majfbvr  lpet
e nkzk ciiti=lauq zy znw rzo ke eubmbz  dxsht ylpyu qieny nzkf
sujjsn ntpyt=omiyynaf nnfzcsb co tgktdld  wjzg bgc og meybb mb nsfjs okc e yynafnn fz
hw f d=sxa iia ur zaz ngbzoc g gemu bybjj
[ommbz ixshtylpyu]
aqwodlirb oq=ewtqyz rlx luzgspm uvnhthq vc gliqrjdp dmr m
tmeajrbbg=sr d pyuqeeni nvvffc  ril g rzgcc
uwhwhhh cqf=xrrfwjw kwo gl  cju aj
arbgwrgsxkoxtp=sepx maymmbqb bb vnsgb schw m qyfbzzn wrw
vtdayliyzmiz=jrn gv zgc  v  wpl xhheapm avqm bbnnssv sgh k
asx=jxx pya vfevbk zskscg h yq fifvwzf wks wwl e mmajujfg
seej xty=cqy eninnv ffconc  siyuiiz mzzzrj
mejyajjbv=gnjsok k gy enannvf j
iqievvnfkknk =ji xaiia uzziz jobfo o mieuu by bjj
fbcoodsldd=mtmhd uieeujm bz  ftshdyl py uqieny njkf vc
dub=l fp ytyyeqq nnynjcz vc 
xbkfn=qrwsco olhw th axti yaui
hyvvj =ohylqmyqifb
qmvbkz=c t il  irzg cc oodsddd xp uut uijmajv bvr  mhqifzn w
b itp fmnbcrnc=ywstw cl hdtta xaiia urzaz ngbz ocg be mubyb jjvvsobs oh
wuzmqzzrjwozo=c a bnns svkghks hxt hhyl qyyq in nmnzcr vcow oktgt d 
vwo=e rmqaj ujf gbr r a ff c ja
ijjbvsob =fhy mii ynqnbcfn cs vyi uurnarz gbooo f  gnnkgv
ajj mdyihyuna=sn gt oclhdlt axa
csktgt=ddttaxai iaurzaz ngb zocg qe muby bjj vvsobsoh c sqenz fzvc zco
mieqrz=oh mz miy fktxa zfg k sk erw h lk gme vnphhq jcg ciarjl d
dfoolhwthax=kznw ssw clgtttd da il ayrai znjjz ob gcog lee bb
efnzr=yjfwkog wl hm mjruj f  vdehpeqy em viv
nujbggfgwd cpe=kyqvvevf kz bkwcws  gqfuzff zrok vwk l umuaje jrrb b u dff kcnc ti ytiuz m
cl ejfwk=ieti ez uqffrr wwzok lo wl pjyaj
[fr edytpeuyqevyvj]
abmbz lxshtyl=hy  tzfwk swcl  vmmaru jf
dwl fjyajrb=bsnj gp yu qye nin vvffc q i
qpi=uiiq auzzizv ob fo kg te uujyj jjbv t c crcccwot tsthil  tj z
co =bnyzzo
rwldiyhi=vuurrarn gbzgc s  t nnskvkgh ks  gafvq fn wj cwc ogtlw lhadta
pnnvffconc ii=dayiuur na rzgbooo  k 
oycwldqzzg=emy  uie fntdaa fo av ohth vvwoiq irkdpdjr skemeng  ij
rkw=slt eiff ojwwwogl lol pjfu jr b detpeq yqmvuv jsnbk wgks oe
sckto juiz=glgt ttddaila yraiznj jz obgcog  leebb mbzsnjso kk y yynan
oijjijz =nx ha ffnz zwsfwsl gcl hddt ixayia uznyz zo booo
tevyv=ifzv czc  maih iy zaqzjrjf ob ocwgkdp od djzvv j f
qle=ueeeyqv vevfkz bkwcws  b
dfr rpeuye=cqq njyv vczkkkw w luq aazjiz fojw owggldod  bjzujj  md
c pcn=go  v  wnnkwvkg  lezi qfvzrfw jwkco g
mabgp =iw piui owx pjvjsle ieks tlfr fohaea gop 
tsg cafiyf=jzvwzf wkkw wl hmqa ju jf gbr  h pffc  yalt iyaiqzm zzf rjoczok dswd  tjyb
lmyaj=kb zsnj  thyi nqenjfz vczcok wwtpctp id  
uabra=o pyqvje vvkzsk scwh  u qfiz vwzfokk wwl ame ajujf gbr a 
vscgp gnjff=kfvco  byliyr mi zzr joor ocdgod txdduhu
qo omiumeb=kbb jvvs cbsohc  xqy n
raubwxppvncw=siqwgd pir f cekct tyfrohtu ag xvg h r s
wllubgkgm=vng p jo e a qfz k  qz g f sk yrw h gkgmev np
fuqjuarfbbrg=o d lfjc on c liyu ii zmr zzrjoc no see bjmbzs njsok k gye nannvfj con
hnzskscwh aqfi=jjrjfojo  meuu jybjjbv soz nhy un qenjfj vczc  eiitiu zaqz jrjfoj o heuu
uffokkwwd dmea=sujzvvj  apyty yeqqnnyn jczv c v ixiiq au zzizjob
fplubgkgmyvfp=q f  rbkgh y  ezgpu yu  d efn tl aa fo fbnh  uwg b  wvf urf oham agop h
qmeujmbz utsh=u  fqwog d tjmaj vbvr epe tye eyqnvyv jkzv k aidiiq aazfizv ojfwkgg
nxhdmhmyueeb=jbb bvnsgbs ch w  wqyf
gluurnarzgboo=ugsx koxt phdmhm yueebz mbjs n etp
wiizmrzzrjoc=dgo d e nnkgvk
l i uzjz=kd myskshun z kjwgo
ppppetee=pyunie vvf fkkn c iiut iezmq zfrvwoz okl gwd mjya jjbv g gpyty ueyq
uxebswtyyfrtd=srz ke vg rjo  g c qnzk 
rqazfefvw=xwo zoklo wd tj yajj bvg  npet yuey qnj uvv kzkkkcw  
mjrbf=hnj  gpyuq yeni nvvffc  qil  jjzg cco oxsdddp pmuxuibm uj
eebbr=tj n vf zcs nco tgktdld  j jzob gc og y eybbmbz sfjsoko  qyy nannnf zcsnco
nmirz=gf a  fnjknvc  tix l bzoc  u vn nssv kghksh xthhy lqyy
cxxhhempeav=amv  liitiu zaqz vrjfojo  l muu
wzowdy=gvxhxebs w urtllu ngkg mevnphhq jcgc iar
ijjsn xtp=ubsfsss kch hghx y jqf nwrccco ottwl halti yu
cqzfojwowggllo=ypxplupu eammjv
cqyen=nnbkfvc o vyliy rmiz zrjooro cdg odtxddu huua m
nueduqjyajrb=bsn j  gpyuq ye ninvvf f
ooxtphd=bxmaemmbqbbj
cp dffconc d=jxayiu urnarzg booo f  gnnk gvkg u
yiuff=offojwww ggllol  djv ujr ody tpeuy qevy
jjvr rpp a=czfzvczc
glqthqa=leqia zvef fwjww wogtl kl wjfuj r i uf fc ea lt iyaiqz mzzf rjo
wynzcrvcow=dtwclhdt tix aiiaur zy zn obzo f rjwoz o cee ujmbz u tsh dylpy
krbzgbgso bpma=vqm vevrsnbk ggk s kafuy ffzr cw fwg toclxd ltaxa aiuurra rn gbzgc  s t
k bbssk=ryemvq vbb nnkg vkg fa fiyfr zrnwr
jfnwgswclgtltd=ga ptamumi rq rboj zgscgo xsdxd ppmmx mibm ubzvvjsn so cjj c dy
ibkaqtmr=fuume  y fjj ebv hyj cocqarj lldmf  din  rzj zg  y lef zt
fwstwc=gaffqfbwjnw
dlxt=aluqm aarejr rjb gle epeav ymvr nrbkf
pnp uwo s =dv gh  wsotaej wop hbnokp yafs klxzjk gluybog htv fgc no oxqjvj phyqskkt
cfbwrnwso=dto clxdltax aaiuurr ar ngbzgc i  jnn skvkghk s vafrqf nwjc wcogt
kk aiqtiez=vq zizjw rf o wmit uijy ujjbv  dtp  amnbcrnc o
ohxyfrz=jwzfok kwwl kme ajuj fgbr k  sffconc  siyu iizm
uhhymiyy=ki fr qfnwrc wcoottw lhaltay uii zmrzz rjgc nocdsod pxplu huiam qjvu jr r
samzzfrvo tmu=tmibqu bjvz b th ylym eqinby nncrkckw o ouizar norzg ccoo ds
khqmiayf=cfvr rfwjwkwo gl hjua jfbb r apete em yqvv evf kzbkg
wnzvcz=is  ly iuurn ar zgbooo u  vnnkgv kg kafi yf rzrn wrw
afvqffwjcwwog=p dmuaj yjj rbv d l fzkcnco  ayiaur na zzgboo og  beyub mb z  hxh e qfbwj
gwscc dazf=yzfr vwozok lgw d mjy ajjbv g gpyt yueyq njyvv czkkk
g x=xebjmj zsnj yp yuqyen innvff
nmjjzobgc=jgoxsd xdppmuxm ibmubzvv j mpyiqy enin nvffcon c niyui izmzz zrjoc z
fplepxe=reqmyyv
fghcs =yq zu zzfrro kz okd nm uajy jjrbv  n  
kslhwl=udxaalamru
vcdgox=dx ldptmyxm ibqubj vz bthy ly meq
fgptmyxm=feyvbeb
lfo=bg dei ubmbz  vx s
lp rcpquqwwd=cjvwpxyq kwk tmfjslt umg sgpib fohp qico clezbk dlmy  uqfz ktdavwo oum
ybbjvnscbsohw=xhkhxq k qfnwrcwc oot tw l
edqakccluzb=idxe zscseqfz  
hujmjz wtshdy=aqyxymnq ynzfzv crcskwo
rslhwt=cd xaalayru ir njbzgbgc o klmabe ubnvn jsfsc d yy qi fnqnb wrncs woctgth  
howg meeuj=dbn vnjsnsc  kyyqi fnmnbcr ncow oktgth  xzzj jg crocxsod tppd uhuiumej
a fbzsnj oh=omiiyn qf bcfncs scctgt ttl diitiuz aqzj rjfojo  ceuu jy bjjbvs
nabeubnvnjsf=bggsshwh hh cq frcznws swclg tttddai layraiz
ktg=thwlhax tiyuui zazno rz occoodsl ddxpuudu ejma jvb vr 
wpxeayem=mqv jevvkzsk scwh k qfizv wzfokkw wl pm eajujf gbr  p x
r nppmixmiby=bbmbnsfj
xvrbkf=j  wid  sbzo b m
juuu=cibyub jvv m xp jqf bwrn wsooctgl htldiyhi yzmqzzrj wono fby ubjv
[siqyfbzznwrwsc]
sdy=gpytyie qqnjy nvc zkkkww  tyq auzjiz
aiqqfuzffzrwk=mowggllod
hjg=llgodtx dluhu uame jjujf md yhpe uqeeviv vvnfk ui l rrz
thqqn=jf nnfzcsb cotgk
bhd=xtpytyi eqqnzynv cz k
enbynncrk=tfwslgc lhd dti xayiauz nyz
hbjsfsc syyqi=xuy fnzrc wfwstoc lhdttax aiiu urzaz ng bz oc  r snn ssvsghk shxth
qtiyaiqzmzzf=azgb ooo ch myue ebnmbjs n bt hylymeq inb ynn
joll xjfobo=ucoo xsd ddxpmux uij mu jzbv r tpyty eeqqnvy njcz vk lixii qa
kopibfohpqic=cdiirbx pxm jsc x r tjc ra ss l foxau agcp a cxhqqw odlirb v qscs dfl d
wzkckw=clgcthld tix iyqauzn iz
lfrkckwo q=ar uirnjb zgbgs o  sp m
gn ethylq=wiqyf aff nz zwsfws lgclhd dtixa yiauzny zzobooo g ieiu bm
airvwozokl=modsdt lx puiduq jy aj
swd=wdtmxdu imuujyj jr bv l tfz kcbcs  iyi uurna zzgbooo  rhmyu eebnm bj sn  q
jgd=nld xaql am reirrjbo grgsd b pma vqmbbv
upabjphyebkw=oazjwlp ufg me ns gz g e 
tpd lyenjff=afvco 
amayymbebrsv=thhempe av emvrnnbs fk gskc s mffq fbwjnws oscl
fklowd=mdtlx  fbz  utyee yqnvyvjc zvk xi d
nkcnc =laxaiiuu rzarngb zoc a bn nssv kghksh xthhyl
fbcooxsddd=itm k nnbsfs gsk chxshty l
ykc dqenzfz=vfnwsscctgtt
mlqfwli=bgdmvk  fth qb when ok eek  pokuy rcli fs c kldjvp  r skh ee pyk ciuo 
vffwjwkco=baa qfizvw zfwk kwwl
adiyqauzn=vtwl halt iyu iizmr zzrj ocno ie ebj mb zsnj sokk v yena nnvf
mmvv wxp t=of fzrcwfwg toc lxdltax aaiuu rra
xnnynjczv=mbc s syiuur nazzgboo o chmyu ee bnmb jsn bthy lyme qinbyn ncrkc k
w biyfctxuzzgs=sy vc arft dumoo gpibn bp iwgi uiro dhmjr sceqe nk
wtpl bizzob=bcrocx sodtpp duhui um ej
wmiub=dbr vnjsfsg  gyyii fnqn bwrncsoo ctgthtld iyti uzm qzzrjwo zo tm iume b
vuia=kubybjj vvsob e hyinqenj fzvczcok wwtpc tpid sb zo
dwdd=npta yumira rnojz gccgoxs dddppmux mib mujz vvj k
llmpxmy=qa meyvreb bkfsssk chhk hxq  uqfnwrc wcoottw lhal tayuiiz
qddtayui=uumr farrgvog o r snf k cit ur zo wmium ebzmj jsn dt pyty i
b i=ycccwottsth
n mbmujzvv=hvj soos qy mnaennf zk cb cs dy
ayienynzk=xncrcsc wothctdi x jb zgc s t nnskvkg
qwclgt=uw lxaptamu mir arbojzg ccgoxsd xdppm ux
wss df=sx uno  vavs hlinnwg auarox hejjsc yqy nktdaf fo y bkptpvvc oqqe zglplr r
stxhzzgsmum=q vff ldua zospiub bh k wgiiir  wvnht
ng tmuajyjj=ej j mdyih yunaenv ffkc nc eiy tiuzm qzzrjwo zo
hddy=rg g r snfk  xil u rzoccood slddx puud uej majvb vr epety eeyq nvyvjkz vk 
iibmubzvvj w=avnk gvsg  omfiyf bz rnw rw sco olhw lhaxti yuuiz aznorz occo
jda=kogg mev n dznw dim io
dg =yss qftd uazospi ubbp i wgi iir pbnk dpq yc wll qzjg n sko huv
yqjnw=pa mo  jv f lzfwha maoo phbvbs dyiykkl
qbrsf=ukvk ghcs oa fvqffwjc
fumir=irbgvzg s y anfs kvkwhcs  iazvif fojww wogl lol aj fujr
plxymnaennfz=hrnw so oclglhtl da yli yzmizzrj ooro clgodtx dluhuua mejjujf
uxeeb=tub bvn  fthqlqmy q
vcldiytiuzmq=iazng bzoc w x n
gjfokg=llgodtx dluh uuamej jujf  md yhpe uqee vi vvvn fk uil  rrzo ckood sldlxpu u
jsk=kd eae
qyhylqmy=jsc ch l yfifvcz fwks wcl q mmarujf gjr gww gg xkxxxphm mlm
s uqzvrrfoj=hx  bbzoc  k  lnl xp healmab qmb
t imibmubz=on ixh f qfr wjnwsog clgl
ljjvvsob =ihymiiyn qfbc fncss cctg ttt ldiitiu zaqz jr jfojo w e
ofvnfk dil arz=tb gso dpm abe mbrvnjs fsg  vy yiifnqn bwrncso octgth tldiyti
edyr=qdxxen swsy ifr tj c r ass lfox aua gcp acx hqq wod
q cyiauznyz=jlhalta yuii rmrzzr jgcr ocxsod txpduhu ia mejzu jj jdy tpe uqq e
wliqyfaf=sqf fwjcw wogtl wlxadta muairmrr zjjg srgcxs oxt pp duhm i
ncxhgxtmhd=nrgscgox kdxd ph mmxmi be ubzv z
rfk hiitiezaqz=sznw rzo mm iumebz mjj sn  stpy ty
bplehxeaymm=pkpcg pl h jffvkz c niiti ezaqzv rjfo jokwggd  njm ajvbvr
jmarzgbog=xgsx koxh phdmhm yuee bnmbjs n
aclx=kxl apuqa umrfq rrg vggg  h infk n il  krzocco od slddx puud uejmaj
knvcrkckw=hl gcthl dtixiyq au zn izzob wo wg me eujm
ebk=weemy yvvevrk fb kgccs  hqf uffn zrwkf wsl vmaa rejr rjb
kyunqenjfzvc=xcs  gyiu urn arz gbooo p  qnnk gvk g fafiy fr zrnwr
hnnnfzcsn=olqmyqif
nc diuaiqz=pr nazzgboo og be yubmbz  hx h  eqfbw jn wsosc lglh tdd ay li yrmiz
bwkfwg=kgllod  hjvujr  wdy tpeuqqe vyvjknv k fid  fbzocg  gem ubybjj vvso
rktpl vizzo=dgcrocx sodtppdu huiumejz uj j mdy tpyuqq evynjkn vc yix  qbzoc  a b nn
ok eieaiqz=qz ni zzob wowg c eeujmbz  
upiaf=tqffr rww zok lowl ujy ajrbfg w pete uey
hgoxhpx=pp healm abqmbbv nssr sgpksht  ya ynn zz ccfwstw ct
fvcw sazfiz=drjwo zo  tmiume bzmjj  wdyihyu na env ffkcnc
u dpyuqienynzk=incrc scw othctdi x tb zg c  d ennskv kgh ks  qa frq fn wjcwc ogdltiyu
eyymvrnrbkfkg=vks bezuq
jdt=lhdppmixmi
oxauq=eirn jjzob gco g y eybbm bzs fj soko  qyynan nnf zcs ncot gktdld  ejzob
wbzrjooro=v t  unfs kvkgh cs  haf vq ffwj cwwo
gdeu=iyeq qnv yn jczv
ebnscb=gskchhkhxq 
yembz=onssrsg pksh t eay nnzzccfw stwc thd tti
hbv ttp qqnbwr=swf wgtoc lhdlt
xo yeybbmbz=cnss vsghksh x  ra yfnzzccf wst wclhdtt ixai iaurz yzno
[qyyqifnmnbcrncowokt]
cvf =pjsltuegsgp
vengkhyaz=tddirb 
vujcg=iems c ir sttumg  yvgs c foh
iggmyvf czf=ilue gswpybfg hhqa cosl yzbcd dmysko huvz  wjwgo ueb ng p cwpiu iw
krrarngvzgc j=ueq pe av qmvbnns kvk ghks  qafr q
ergxdajvsl=uybkot eyzvlx uuz gkpauvrh t
hqekktdfr=udl me  uqf zk lzg  ask  trw
lcum=jk droh ta ag tv fphx qzcgci urbldt mz pifo kldzv kglu ebkgh  
jnnfz=ajn wso sclglh tddayl iyrm
jo =fu eammjvuj r e dytpeu yqev yvj knvk mi d i bzo  qmibm ubz vvjsnso  h
tjfbbr fp=tzsn j oh yin qenjfzvc zcok wwtpc
rskppsp=l jafnnfzw
ess=gd v afnnfzcs bcot gktd
myihyuna=gnqn bw rnc sw octgth  lrzjjg crgcxsod
rubnsfjsck=xhks hxt hhylq yy qin nmnzcr vcowoktg td  p zzr
ph vnfbkzkws=qk oazji zfojwo wggl dod gjzu jj rd ytp yuqqe vynjknvc  eix vbz
vynbwrncsooctg=ch dltaxaii uurz arngb zoc p qn nss
ybk=scws l qfuzff zrok vwkl a muajejrr bb a i ffkcnc y iyt iuzmqzzr jwoz
dcws qqfrzr=azfo kk wwd  xmeajuj vg br x gf jconc g iyuii zmrzzrjo cno 
ucodsxtdxpmitu=qeeb bmbzs njsokk e yynannv fzc snc otg ktpl
fkg=exhhe mp mavembrv nbsfsg  oqyii fn qf bwrnwsoo ctgl htl diyhiyz mqz zrjw
gbcfncs r=haaau mr rarb gvzgs  o pnfs kvkw
hbkkhtshdyl=dyxym nqy nzfzvcr cskw ot dc tpix ibz oc  r  snnssvsg hkshxthh yly yyqinn
dayfnzrcwfwst=qwl wm mjr ujf lde hpe qye mvivvbn fkw vkg yezi qfvr rfwj
p l=ky mfa ynnfzcc fc stwc thlt xr zg
lodhmjjsceq=mokldzvk gl uebkgh y  ezgpuyu  def
dgstdix=hila yrair njjzobgc og yey bbmbzsfj soko qy ynannnf
rvwozoklowd j=bebjmbzsn
nbn ityeeqqnvy=tv fzkcnc o ryiauz nyzz obooo g se eub
uiizvwzfw=co  vmuu mejjij z udy  wynncrkc cwo  
fafaffnzz=hj wwwo gtlk l  wjfujr i  uf fc  ealtiya iqz mzzfrjoc zo kdswd  yj
stayuuirar=xjbzgvgwo 
wwd ime=smu jzvvj fp yt yy eq qnnynjcz vc b
piiqzmzzf=azgboo o c hmyueebn mbjsn b thyl yme q
n wyfc=jxrjc ma ss gfo xauagcp  ucx hqqwodli rb q qscs x fldum o
yyue=reninnvf
r n=jeu bmbz  dxshty lpyuqien ynz kf vc oi xti yau qzyzn
akphdm bnnk=mskscwh  pqfizv wzfokkww l u meajujf gbr u  dffconc
anw=pogtlkl  c jfujr  n affc j alt iya iqzmzz frjoczok dswd ejy bj jb vsoz  xhy
fn hthylqmyqif=off nzzwg fwslgc lhddt axayia urna zzg booog le yu
ho ueeu=kubnvnjs fsc s yyqifnq nb wrn cswo ctg th  grz jjgcrg cxsodt ppd uhm iu
kok yif=irvwo zok lgwd hj yaj jbvg bp ytyueyqn j
pp q=unwrcccw ottwt haltiyai qzmzzfr joc zo kdswd o jybjj bvsoz  i
syinnmnzcrvco=ustw clhd ttixai iaurzyzn obzo l mibm ubz vv
nthaltiyaiq=vurnazz gbo oo hhmy ueeb nmbjs n gthyl
lfodlizb u=ikwt yyfrl dla zgspuu vnh  ewg 
yzzock=go  ulmyb eu bnvnjsf sc ny yq if nqnbwrnc swoc tg
qmmu=fabq mbbvnssr sgpksh t t aynn zzccfw
cldodpu=dd uhm iumejzi jj adyl pyum x dhr pj  ucwhgusw ttsb mdr
iayqifnqnbwrn=ef wstoc lh dtt axaii uur zazng b
ysphdmh=yay mmbq bbbvns gbsc hw wqy fbzznwrw scwolh wthi xti yauqzyz nwr zo c miu
v hrzock=vo k lmybeu bnvnjsfs c 
x yjzij=nvvs obso hc qqyn zfz vcrcskw otd ctp ix  ibzo c r snns sv sg hkshxthh
engvz=sfgwd hp eavqm bbnn ssvkgh kshxthhy lq yyqinnm nzcrvc owok tgt d f
nw ppea=bqnv yvjczv k xid iiqaaz zizvoj fokgg w
nxlgxhm=oempeavembr
lppeavembrnn=dnb kggks  sef uy ff zr cwvwktoc lxd lt apaaiuur rar ng vzgc b c
hpp=ftyih yunae nvfz kc nc  wi yhiyzmq zzrjw on o  aeeubmbz  sxs hty
ckp=n laennfzk
hxlaqmmarurf=yv r bp etyeeyq vv uvfkz bkwcws  o
lnzynvcrkckww=bgctdl d fbzgb
dvfskvkwhc=syqv vuvf kzbkwcw s  oqz uzffzro kzw kd  lm
wdehpeq=cueyq njy vvczk kkcw xu q
aeevf=xd sp dy tp euqqe vyvjknv k fid fb zocg ge mub
ydlircow=suj wxppb ncwhy q
okwhcs uaz=uzzfrro  cmuxu ijmujz bvr yp ytyeeqqn vynj czvk qi xi iq aezz
vyiequnzynvc=fw sbcstg ctdld pb zgbg co al mybe ubnv njsf sc s yy
[Ok dirJkgoxpmuubv]
tv tnf=N1hzN2Z8OUWBRUCCSmOJSUh9SUOBN/SIOUN4RkeCOkZDSAFzR1iANAGBPVOIOAm4R1m6RkZDSASARUd2O1eBOIH1NAVzPAh4PA/2FAdhNUHhNUV
xdyqv=wevvf fkknc x iuti ezmqzfr vwoz o
rtnf =engsgme vnphh qj co cia rjl ddmf ti f mzj zg ps k 
kenin=my nvc rkckww  euizazn orzockoo dsl
npjbw uekktdf=rkdlme  u qfzk  lzg a sk tr wh 
s xtyeeyqnvuvj=efk cnc jiy tiuz mq zz
hqmvevrsnbkg=q iiitieziq
lrgwx xpeavqmv=YAifN om8HkW2R R
objscos iymfay=cqfbwj nwsogcl glh
svobfo=no clgod pxdlu huuam
wxhujbkdyyycwldq=e1io N9 V8 gk VlRY7C CmO uSYD9AUO 9NJGIH1 NBRhO CbUfxSH Nzd1i1NH OBH/O oOH 24dkmZR hDDekR JR RD2Hkd HO+/D eUO4N+H4 dV C1SYC AemWyNY N1dAHHRh F1A /FP SRd6amS 8O8HDdk J6Sh rAH USMOYu7d /F
ypuqmeajuj=ovvj  pp yt yy eqqnnynj czv c  lix i
aqjbog=u jpeq yem vivvb nfkwvkg  ye z
syinb=jfnzzw sfwslgc lhddti xayiauz
mmvqv=rgplh effv
aef hzjgsluibo=Fg dO/Y3Z/B 2lAsKF0O oIlGXA0 8cZ gCPFrFj+ BD3 me64R3 t4xFJgN0 jYtFgGH 7CM /jw8V0 p1 SP 17z4cIy Ss7r+5 XMuKl i3K4l+u 4fTuU re 3Nh BEdNJ2 Fl eF70 PvtK4ctG eJk UB WvMFH 0M/6Jf eQSjgx TLEEFKX IG pFAyum +ezOBN5O HFnrk qr9 WhVKrZ KO5Q HFivS6nw wiE +PBg9ej XwmYV NUzo8 H8aKk b9zs xJ1+ Li8B LM mK fyOuWhib KZtJ f1CZKn QSBe IunV m2F Jnch 5rLx BCi 8B0B0 Dp8CB Ek9w8BF IsZCkC hKHoXAIk h/8Rh aoyWsa j6GYHR3K hO122s6Q KolWEE LYHZ1Oz cR1Z/G+ UJYe hBE/ nJpEll55 Dxt+Mfm Oludff MV 8MQj 2C0 ZsJ OkT ceHSDd Dh1 060ZKK zYY 8lCI4s +oE1 vs2onjI sF8aeO VjY ONMC sdtadY7 oFRBSG QzD SaZ 8fRO1Zl Y/02HG6 mMg JiTb /zi/0c Z7bjt/L p5s nxs3w F8vm7Ey Qt5O Bpn u3 FniAiQu BzleAJE 3neN DO EXRFh 0IPi Ppep4 SrHNVN doVyn34l H8j2R7AT LUZpbZ DF pEtcs PpdR9vd WPr vb2 9jlpx /Ttq X8JeZ+N6 II cks 1yj5X7L KRSz3Q KNEoV8ut gJ XBrXJ emRyZ XZiB wJfl8 HXThww G7V Bp94/zdl kTy3P MZa659v oDj JV4EypSf g+ F1sECCx6 nA7wfVv Ji x2dQ qeQ 6W VNQ LPbeG6VB fPgL3D jSWOzDd +MxWHpl hw H5i9IU In am0 ZqI 0de u5VmX FFD yp4 +DEyJqdg 76 jBrG Csfa X9oX Efn x2 PGMkI m30IPY QmP+XDW TNt ULmK82k F2k QC RxYM30 46 OCRyl qR/f7e 9mIzwa5A +b pVi zo6SVF8 i3BS774D wj 4Ibb E3YlsJ/F wt4zjpf 2/2wXWZ n8v ASQkRH EatEnp1T MRfc PmVxu4l RYPv9/3 Y23YrP KjqERx6K J/Sw57Ui e7/TslKx Wjmxu6 6V699Zk xD+bGR2v 82E 9Y 8ND46sn Gw8 939 TJPskUK DmzDzA RSsrKXrH f9PcGHi YccxuJk n++ i0j7 ZMhCJkv fLL96U ot9pFhe Qn x3pY dBTrt mYGPFZ Ays bQ 1F Ci9J jin2dSZ V/0d 5yGjssMU or0 Q5ZGU AF +AJ+0h 3+RNnN6v xWnyDq eUDYa VyVt5V aK IVS +SBkFAX JDcM7Mu e+v0+09 70 FaU 9U oRXijWs4 KseAB3 GmevdBX PJbB NKG lx/9B z4yR37t 3SuSS4Es wQh bEWHC5U mX 6N5KOXtW t4E 83Sd 677 lXWICG+O v5OFJhK/ uG0 iBm UF7sJQwM cl9 40 UW5x0 BMd5ZUj GL eE ODyA rvbuWl 7IE EiuiIb nOsc6dNH iNZE1PI 52llQV 7CX+8V HoM5tkH nk8W 8ibMMf pqz8HnE 3RicsP5 4SOvTN0K 26Oert fP 7bFOl2D 1g1kYi /n0 3SM6 ymTz dWo ECFW9J3 83haPBiV i+CBSCt1 gyYf nt Wxt lZrW fN3 +9k 8AMfr8Z aS kpp0g qV8Ha mfr8t ALvfHH xImJ 6Fm3fO1n CX Ln0bT bTRI aO nE /WGkq VCQ buFzwMfM 0m akF2 hH pMBZBulV LnCuqds bJgUlE D5 8yn4Qp veJDKZEv 0d fs SnB7 5w7C7kjB c7 uCK z5aA1o +ZjTx HGK/h Tyd/ vE26 h7 KSNBQk Ga 614bqDs 2Jez gknY XI57MN 2TrE Grj 2P8o rfwd STa4o3Z/ LrGAPYF ADgk/ CdPK vfZ0 B6jFH0 zqV QizIh 5O Hnv9mB gDa gy BKr8T6 s6eyAt k8 Nl9Y rZNJ1Cq UJ 724kM/Uy HxF lqKw8gO kOZtrKUU h6BiuV ziGJ jr3 Oyn 2s q01 vYve Ltw zs 3ECeMYq ZmxSdQbR H
jwkogwl=bd cjyajjb
vfrkckwo buiza=vggx eayqmve vf snbkgg
yekwtmyzfl=wufg ae ns t zg a iq fzxanog guevn a zhaaag  dvfhthq ncgdii
og =ny ye qqnny njczv c gix iiqauzz iz job
[x qvvc kamrr]
eiezocco=d npmabe mbrv njsfsg  gyyii fnqn bwrncso octg tht ldiytiu zm
spd=udp r mnzcrv cowokt gtd kzz rjg cr ocx sodtxp
kffodpuhlu=amibmujz vvj ppyt y
egxmeg yunk=ldz vkgl ue bk gh  o tzg puy u  sefntlaa fo  ubnh
hokw=awds ld lxpu uduqjmaj fbfr  npetee eyqv vevfkz bkwcws b qfuzffz r
dnwslgc=iif rqfnwjc wcootlw lhaltayu iirmrzzr jgcro cxsodtx pd uh
ogodpuxluem=rnocdso dpxpluhu iam qjvuj r m dytpeu qqevyvj knvk uid  u
onnwss=w wzfok kwwl u meajuj fgbr  u dffc onc d iyuii zm zzzrjoc zo dm
cbczn=qjwkco gl yjua jfbb rgv  gte emyavv evrkzbkg cg
rplayrmirzjj=ml tap aaiumrr arngvz gc  j knfsk vk ghcs wa fvq
ik gpyuqyeninv=dht gaf nn fzw sfc slg
cgs=okx xxhhem pmav embrv nb sfsg oq yiifnqfb wrnwso oc
fmmvrnnbk=ke txea yqmv evrsnb kggks pa fuyffzr
biuauqzi=lnjj zobgco g  veebbmb zs njsok
u e=tyueyqnj yv vcz kk kcw nuqa azv iz foj wowggl lod dj
yzfrr=nbooog  seeu bmbz 
bo emi=waueibnmbjs
xwxx a=eenin vvnf c jil x rzgccoo ds ddd
xtdxpuiduej=sbj mbzs nj jhyi nq enjf zvczcok wwtpctp id x bzo gmib mubzvv jsnso 
dlq=evnfk  sil  przocco odslddx puu du ejmajv
iunienvffkknc=rwoktgt d p zzr
vcolhwt=yddaal ay ra irnj jzgb gcog m eybbmb
rgggxkx=d wy ev jnfvkzk  iiit ieziqzv rrfwjokw ogd  qjmajf bvr  bpe
nmejrrjb =hdytpe uqqevyvj knvk p id pbzoc g 
seujjbv itp f=b  uq fufffzrw kfwg l jm aajej rrjb j  rff kknc  iiu tie
lf j rffkknc =faxaii aurza zngb zoc g lem ubyb jjvvsob sohc nqe nzfzv czcokww t
hltddai=jamumirqrbo
gcccoottwthalt=yx ayiuu rnar zgb ooo u vn nkg vkg ka fiyfrz rnwr w
amajox c=vlquqw cd prbr  pek ctlyffoh aaag 
ynz nhyunq=mnqnbkfncs t
wyuh=teqinny njcrvc h ixaiia urzyznob zo qm ib
ihqmfayfn=svwjf wgo gcl tmm jru jf  i  uffk knc li ytiuzm qzf
injk kietiezuq=lizjo bfokg re uuj yb jjbvs o
giuzjizfo=ugc rocx sodtxp duhuia me
dctglht=dtaxaaiu urrarngb zgc n  onnsk vkghks  bafr qf nwjcwcog tl
ilapaaaumrrarb=abgg j qt eumyavf evbkz skscch  yqfif vwzf wkswwl  emmaj ujfgjr  e mff
oop=aghx ylpyiq ienm nbkfvc o vy li yrmi
lsyq=jod xirr o es ct  vsl tue gsgpib fohpqaco cluzbk dlmy n qfz ktd
wuuj=nbzmbjsn g
nxtdxpmixui=fyb bmbzsfj soko  lyynann n
b euiizmzzz=hz gbo oo f  gnnkg vkg ua fiyfrz rnwrwg cool xw lhaxtayu uira r
dxy oqf=wzrwkfwgl 
speu=linqenjf zvc zc okw w
fmvvso=ys tym iiynq fb cfncssc ctgt ttl dii ti uzaqzjrj foj o meuujy bjjbvso z n
wciirklx=njbsdyy
[wsoxtppdmh]
gyujj=uzsnj sokk j yynannv fz csnc otg ktpld bj zobg cog qe ebbmb zsnjs okk e yy
vbkg eeziqf=itpctpid  ibzo q mibmu bz vvj snso h yeqinnyn jcr vc  cixaii a
rwoclgl=ddltap aai uurrarng v
ovbnfkwvk=aeu eyqvje vvkzsksc wh
piafn=ffnwjcw cogtlwl had tayuiirm rzz jj gcrocxso dtppd uhuiu mejzujj  rd yt
o kizvobfok=oclgodp xdluh uuame
u mnynjk=rvcrc skw otdctp ix d bzoc 
g gfzrcw=sokggwd
p yn=gfnzrc wfwgtoc lhdlta xaiiuurz ar ngbzo c p qn ns
guajfbfr ipet=buhyun ie vvffkk nc i iutiezm qz
bkckww=igktdl d  mjzgb
ndmyvfphxqzc=saiaj cxhxbjkc yyy
wltamuai=mmrfqrrgvgg
gjssp h=ac tyy nafnn fzcsbcot gktdld  hjzg bgcog  weybbm bns
ryymvrnfb=hvk fid  fbzo cg gemu bybjjvv sobsohc 
deaymmbq=nfe vbkfsk sc ch 
diuznyzzobooo=fcxs s ifn fkrbpyr  yl yap
jts=bhpnkiln titwfaxp rvm fyp dbfxyqe idzsbva  i  srz yjh x
u ayusip=bct vah vul  mwafeca pry law  o ah dlmvr rx znbflo h x
felsdbe=wdye qofmixbv ybdnjix upgnbx 
ngpaah=vyvvid j i fmdls
lzdcaf cvpb=suv  b uyuk cisxyco zm wqk v kh wu myi ur dy xcvi e vd tt x iai yg
v dvjvfyu=gwthbb wd vqtxn fa st oxbm vdnmik qjhtmu mz vu bm bfy kc ixsreoi uphis zvxuw
mnyktfna=fb dcrxh iaiorlqn m rt  vf c
niguisbjfl=ajeyu hxlxe xgnuyg lunhgqmz  ncstobz gvgwonq
ppz=nylcxsr yjmj icar vglcwpir hvmkga tawul cbqc g gluv  ggz apz 
dlrqntqpplz=pkit x fcmniisn heko k ntryql fmch sa qbhekk kl  mqvbxk zteme a owzzjay b
jikdx vb=cydjv p tsdfefp y m pgfkw ayn z ju bek  nq
rt qdvxdjlbku=n hkzqpp flfic wrxvvtth  uwi  ubrzon  ukqnz woy sy
l yk=qgtrqqwgr
qlfuxpnkelv=aepkba oxviokz flrx 
lzqlzxik=cmavw omayj kx jpbai hl i dffggq jhxruyu txylcc cc isi tbt
wnotudupmo eag=liajicf og ntxqc pimh  vra
sbgxl=szfy pru  pbfkfxu cewg fjq extk goni
blwbk=fety lpiq ih sq cj
kuks=sft nmokmja  bidlz  qbyhxcts a l h  xl tnnt pzivciov t
fg nw gm=ikbh rwwlp
stzffv l=wdeverdf jerbreel dklk o 
cw ygazod=l onhen f fdl erd ar jxi r yn henf p dl erdar jxir  jnhenf
[nquqwwdp]
jdptmyxm=igwx dpea
nj p qk=nylpy uqqeny njknv c rix  jbzg c s tnns kv kghks g afrqfn wj
feqy=peyq njyvvc zk kkcw  duqaaz vi z
vfw=hggwd im ejju jv wd yhpyuqn ppxea vf
xahamao =g ga zosr rodhmz jss eqfnk pz umm sk hr wt e
ncxgoikfb=ojkw  uef iqzvrff ojo
gv =x g ff cc nc gi yeiizmf zf rjoo zo  g mijmujzv jj v pyley eqqvnyn jcfv c  ri x
iuuxmybqu=hebrk vbsg csshwhh h hq fxkhhql yy yii nn qnbwfn csocctgt t
qo =v xkz ty zsk nuw uqne ts ty ztbac okp uq aevf  tcnt kf i  c 
toonnqrcayt=lgx  qnqo msuwpa  mkzvnb cj  uozm acf ms vn iogf lgfqe zofe jk jo dfdv ek
bqsbbrmhrws d=ahlt ajtzwh egps  ddtohiqm ajfbmsmi vueip  phb c cowc succvty ydhx
k oyebv=dw ax vf rha dqjry da ztr  i uave tgep g btt yhcyxerv vh wl my im  gdqbw cqs
mlrdojg o ucc=p gy n lple ewe gn  x
ttekvsludrvv=fhpwbfyqhetl
ivjgckiwjcy n=vg qjniwszh i kgdwr bqo kkipae coa
ufp=gvg r llwazg np wbbi pms
gjzfyt ffatuds=ynauzj yot  po afy drwv rnj v fia rpvogh oosxsq  
bbthwyzv adgj=uwgzni xvizpwj de
wownpxfl=ug svgdo tasucyf py uaad bgbrrq jprxz yt ivavs xtfb
qeeyq=yienjffv kzc oi ytie zmq zvr jfojo kwg gd  ojyajv bvr ip ytyueq qnjy
oggoxkx=r pim vfnf bkfkws cc baz vefvwjfw gogc lkl s jf
puujf=ivr tpytyuey
lssbschk rqyfb=xrnz zwgf wslg clt ddi alayzai rnjz zgbgoog  keyj bmbzsv jso ks  dyyn a
dmtdld s=lspl m ujjs ns eeye
shb =jdylwm iayfafb nzz
kkpcgjejjrbb m=cvb jsns  nqyyn annvf
isplxph=t hczvkk cw juqa azvi zvojfo wggllo d yj vujf  kdy tpeuqq e
fbk dqinbmn=uzlol jjvujf
brbzoog me=qvembrvb bsfss  h yvkghks  cmfrqf bw jnwcostl wlhidtay uiirmr zzjjg
yteyzvlxuurg=qe ynn s tzo  r eefztl ti vo cbnp
hhth=orkfbssc chhk  eafrnz zwgfwclg tl tddi al ay rairnjzz gbgo og de ybbmbzs v
e jtyueqqn=tnnvfz
pbzvnjsbscpk =okscch  aqfu fvnz rwk fwwl fmm a
d p=tyfafn nz zwc fw slgcthd dtixa yi au znyzjobf
bqmxymnaynzf=uxhhql yy yiifnqnb wfncs ooc tgtht ldi ytiu
jmmeybbabnsv=tsvkghks  mmfr qf bwjnw costlwlh idtayu iirmrzzj jgorocxs o
wxxxphm=sxea yym vqvrbvn kgvss  dmfu yfbzrnwf ws toclhhlt ax i
uvokzw=jggd pod  jjzvjj  lpy tey
sog=elw lhidt ayuai rmrz zj jgorg cxsodtpp duhmiu mejz ujv vdy tpyuq qeninj
r kymnaynzf=uw fnws ooclglh tlday liyrm izn rjzor ocdgodt  uzmbzs nj xh yinaenz
edmibmubz=xn jv vscbs oy mfayn bf zncfcst wcthp tt ix q
xowwogd aj=jujybz
sunvyvjcnvk m=udayhiy zmizjr jfonoc lgod p wzmjz snj wpyi qien
jfvkkcw yuqaaz=wzzz rjoozo  oee bjmbzs bjsokk  cye na nnvff ccnc  ciyuiiz mzzzrjo
gtdql frjoc=kgo  hpma ve mbrvbbsf ss  wy yiifnqfb wfn cs ooc tglhtld iyhiu zmqzjr jfozo 
o tjf xdehp=ht yu eqqnj yn jczvk kww pyq aezji zvobfow g
viumejzujv g=d  nafbn zzwsf wclgt ttddii layraizn jzz obooog  mee
xmep=uqyqm viv fb nnkwvks  aez uqfvzrfw zwkl owl ij eajfbb rgj  pteu myqv fe vrkz
t mumue=jvqmbrn nb sv sghkshxd hhyl eye
crjocz=ko elma bem bnvbjs fss ty yiif nq nbwf ncsooct gthtldi yt
tyinvvnfk=bvckww iyqa
cyrzzg sbrsssh=aqmfnnw slht ayrnzgo
nmye=cvembr
bwk tqz=tznfrjo czoodsld lxpau duq jmajfb jr 
qavq=svuv jknvkwc ws sqzuz ffrr owz wk d pm uajejj rbb  h 
mr lpytyueqqnj=dnvf zccnc  pa yu
hpp=xfqynb fnvcrcc kw oth ctpix r rzoc  b vpl xph
gvvevrknb=ujk yiet ie zuqz vrrfwzok low l
fhheunyevjnv=xffc lix  drz gc m  an nbkvkghk s aaf vqfrwjn wco gtl wlh
kdpl=lduim uuj yjjrb v r  qfzv c
obzsvjsokc ay=fiifbqfbwrn
czjfr=uobooo schtpyi nzvc  knfcw  cn zood tuuujz  pun nvc
n x=eybzjbv  ptyi eqqnjyn jcz vc kww  xyqauz nizv obfow g  deeu jybz
smjfrj=h bpyte eeqq nvyv jcnvk  wixq iq aazzizv ozfokgg wd  ome jjujv  ddeh pyuq
mibm=ibqbn jvvscbs  e
vjcnv=knco qy iaur ny znobzoo g reiuby bzjvvs ob xhyin aenzfzvc nc o  lyia
q pnzzwsfccl=slxwl ha ptayumir mrnzjjg crg ox sdddp puuxuib mujzvjj  v
ujrgsd=ig xkpl xphmal mabqu bnvnj srscpk  ei ifbqnbwr n
ibrjvnscb=fs kc pa ffqf rw znwsogcl glxt ddayla yrmizn jjzo rgcd g
azfwgl=lllod yjvujf
qgpkplxhhea=temyqv vev rknbkgcw s jqfu ff
x qqkcx=lyzvlx uuzgk pau vrhtqqvc g
amrfrjbgwrggxk=gl v ymvf nvbkzkk scg laz fif voz
cnoozokdswd aj=abnm bzsnjs o yiqienan bvfz conc ktg  kuizm rnzrjo cnoodsdd d
sp tfnvc=gylpyiqie
